1 1 1 1 1 1 1 1 1 1 1 1 1 1 1 1 1 1 1 1 1 1 1 1 1 1 1 1 1 1 1 1 1 1 1 1 1 1 1 1 
1 1 1 1 1 1 1 1 1 1 1 1 1 1 1 1 1 1 1 1 1 1 1 1 1 1 1 1 1 1 1 1 1 1 1 1 1 1 1 1 
1 1 1 1 1 1 1 1 1 1 1 1 1 1 1 1 1 1 1 1 1 1 1 1 1 1 1 1 1 1 1 1 1 1 1 1 1 1 1 1 
1 1 1 1 1 1 1 1 1 1 1 1 1 1 1 1 1 1 1 1 1 1 1 1 1 1 1 1 1 1 1 1 1 1 1 1 1 1 1 1 
1 1 1 1 0 0 0 0 0 0 0 0 0 0 1 1 1 1 1 3 3 1 1 1 1 1 0 0 0 0 0 0 0 0 0 0 1 1 1 1 
1 1 1 1 6 0 0 0 6 0 0 6 1 0 0 0 0 1 1 0 0 0 0 0 6 0 0 1 0 0 0 0 6 0 0 0 1 1 1 1 
1 1 1 1 0 0 0 0 0 0 0 1 1 0 0 1 1 0 0 0 0 6 0 0 0 0 0 1 1 0 6 0 0 0 0 0 1 1 1 1 
1 1 1 1 0 0 0 0 0 0 1 1 0 0 1 0 0 0 0 0 0 0 0 0 0 0 0 6 1 1 0 0 0 0 0 0 1 1 1 1 
1 1 1 1 0 0 0 0 1 1 0 0 6 1 0 0 0 0 0 0 2 0 0 0 0 0 0 0 0 0 1 1 0 0 6 0 1 1 1 1 
1 1 1 1 0 0 0 0 1 0 0 0 1 0 0 0 6 0 0 1 1 1 1 6 0 0 0 0 0 0 0 1 0 0 0 0 1 1 1 1 
1 1 1 1 6 0 1 1 0 0 6 1 0 0 0 0 0 0 0 1 0 0 1 0 0 0 0 0 0 0 0 0 1 1 0 0 1 1 1 1 
1 1 1 1 0 0 1 0 0 0 0 1 0 0 0 0 0 0 0 1 6 6 1 1 0 0 0 0 6 0 0 0 0 1 0 0 1 1 1 1 
1 1 1 1 0 0 1 0 0 0 0 1 0 0 0 0 0 0 1 1 0 0 1 1 1 1 0 0 0 0 0 0 0 1 0 0 1 1 1 1 
1 1 1 1 0 1 1 0 0 0 0 1 0 0 6 0 0 0 0 0 0 0 0 6 0 1 0 0 0 0 0 0 6 1 1 0 1 1 1 1 
1 1 1 1 1 1 0 0 6 0 0 1 0 0 0 0 0 0 0 0 0 0 0 6 0 1 0 0 0 0 0 0 0 0 1 1 1 1 1 1 
1 1 1 1 1 0 0 0 0 0 0 1 0 0 0 0 0 0 0 0 6 0 1 1 1 1 6 0 0 0 0 0 0 0 0 1 1 1 1 1 
1 1 1 1 1 0 0 0 0 0 6 0 1 0 0 0 0 6 0 0 0 0 1 0 0 0 0 0 0 0 0 0 0 0 0 1 1 1 1 1 
1 1 1 1 1 0 0 0 6 0 0 0 0 1 0 6 0 0 0 0 0 0 0 0 0 0 0 0 6 0 0 0 6 0 0 1 1 1 1 1 
1 1 1 1 1 0 0 0 0 0 0 0 0 0 1 0 0 0 0 0 0 0 0 0 0 0 0 0 0 0 0 0 0 0 0 1 1 1 1 1 
1 1 1 1 1 0 6 0 0 0 0 6 0 0 0 1 1 0 0 2 2 1 1 0 0 0 0 6 0 0 0 0 0 0 0 1 1 1 1 1 
1 1 1 1 1 0 0 0 0 0 0 0 0 0 0 0 0 1 1 2 2 0 0 1 1 0 0 0 0 0 0 0 0 0 0 1 1 1 1 1 
1 1 1 1 1 0 0 0 0 0 0 0 0 0 0 0 0 0 0 0 6 0 0 0 0 1 0 0 0 0 0 6 0 0 0 1 1 1 1 1 
1 1 1 1 1 0 6 0 0 0 0 6 0 0 0 6 0 0 0 0 0 0 0 0 0 0 1 0 0 0 0 0 0 0 0 1 1 1 1 1 
1 1 1 1 1 0 0 0 0 0 0 0 0 0 0 0 0 1 6 0 0 0 0 0 0 0 0 1 0 0 0 0 0 0 0 1 1 1 1 1 
1 1 1 1 1 0 0 0 0 0 0 0 0 0 1 1 1 1 0 0 0 0 6 0 0 0 0 0 1 0 0 0 0 0 0 1 1 1 1 1 
1 1 1 1 1 1 0 0 6 0 0 0 0 0 1 6 0 0 0 0 0 0 0 0 0 6 0 0 1 0 0 0 0 6 1 1 1 1 1 1 
1 1 1 1 0 1 1 0 0 0 0 0 0 0 1 0 0 0 0 6 0 0 0 0 0 0 0 0 1 0 0 0 0 1 1 0 1 1 1 1 
1 1 1 1 0 0 1 0 0 0 0 0 0 0 1 1 1 1 0 0 1 1 0 6 0 0 0 6 1 0 0 0 0 1 0 0 1 1 1 1 
1 1 1 1 0 0 1 0 0 0 6 0 0 0 0 0 1 1 0 0 1 0 0 0 0 0 0 0 1 6 0 0 0 1 0 0 1 1 1 1 
1 1 1 1 0 0 1 1 0 0 0 0 0 0 0 0 0 1 6 6 1 0 6 0 0 0 0 0 1 0 0 0 1 1 0 0 1 1 1 1 
1 1 1 1 0 6 0 0 1 0 0 0 0 6 0 0 0 1 1 1 1 0 0 0 0 0 0 1 0 0 0 1 0 0 0 0 1 1 1 1 
1 1 1 1 0 0 0 0 1 1 0 0 0 0 0 0 0 0 0 0 0 0 0 0 6 0 1 0 0 0 1 1 0 6 0 0 1 1 1 1 
1 1 1 1 0 0 0 0 0 0 1 1 0 0 0 0 0 0 0 0 0 0 0 0 0 1 0 6 1 1 0 0 0 0 0 0 1 1 1 1 
1 1 1 1 0 0 0 0 6 0 0 1 1 0 6 0 0 0 0 6 0 0 0 1 0 0 0 1 1 0 0 0 0 0 6 0 1 1 1 1 
1 1 1 1 0 0 0 0 0 0 0 0 1 0 0 0 0 0 0 0 1 1 1 0 6 0 1 1 0 0 0 0 6 0 0 0 1 1 1 1 
1 1 1 1 0 0 6 0 0 0 0 0 0 0 1 1 1 1 1 1 1 1 1 1 1 0 0 0 6 0 0 0 0 0 0 0 1 1 1 1 
1 1 1 1 1 1 1 1 1 1 1 1 1 1 1 1 1 1 1 1 1 1 1 1 1 1 1 1 1 1 1 1 1 1 1 1 1 1 1 1 
1 1 1 1 1 1 1 1 1 1 1 1 1 1 1 1 1 1 1 1 1 1 1 1 1 1 1 1 1 1 1 1 1 1 1 1 1 1 1 1 
1 1 1 1 1 1 1 1 1 1 1 1 1 1 1 1 1 1 1 1 1 1 1 1 1 1 1 1 1 1 1 1 1 1 1 1 1 1 1 1 
1 1 1 1 1 1 1 1 1 1 1 1 1 1 1 1 1 1 1 1 1 1 1 1 1 1 1 1 1 1 1 1 1 1 1 1 1 1 1 1 