1 1 1 1 1 1 1 1 1 1 1 1 1 1 1 1 1 1 1 1 1 1 1 1 1 1 1 1 1 1 1 1 1 1 1 1 1 1 1 1 
1 1 1 1 1 1 1 1 1 1 1 1 1 1 1 1 1 1 1 1 1 1 1 1 1 1 1 1 1 1 1 1 1 1 1 1 1 1 1 1 
1 1 1 1 1 1 1 1 1 1 1 1 1 1 1 1 1 1 1 1 1 1 1 1 1 1 1 1 1 1 1 1 1 1 1 1 1 1 1 1 
1 1 1 1 1 1 1 1 1 1 1 1 1 1 1 1 1 1 1 1 1 1 1 1 1 1 1 1 1 1 1 1 1 1 1 1 1 1 1 1 
1 1 1 1 0 0 0 0 0 0 0 0 0 0 0 0 0 0 1 3 3 1 0 0 0 0 0 0 0 0 0 0 0 0 0 0 1 1 1 1 
1 1 1 1 0 0 0 0 0 0 0 0 0 0 0 0 0 0 1 0 0 1 0 0 0 0 0 0 0 0 0 0 0 0 0 0 1 1 1 1 
1 1 1 1 0 0 0 0 0 0 0 0 0 0 0 1 1 1 1 0 0 1 1 1 1 0 0 0 0 0 0 0 0 0 0 0 1 1 1 1 
1 1 1 1 0 0 0 0 0 0 0 0 0 0 0 1 6 6 0 0 0 0 6 6 1 0 0 0 0 0 0 0 0 0 0 0 1 1 1 1 
1 1 1 1 0 0 0 0 0 0 0 0 0 0 0 1 0 0 0 1 1 0 0 0 1 0 0 0 0 0 0 0 0 0 0 0 1 1 1 1 
1 1 1 1 0 0 0 0 0 0 0 0 0 0 0 1 0 0 0 1 1 0 0 0 1 0 0 0 0 0 0 0 0 0 0 0 1 1 1 1 
1 1 1 1 0 0 0 0 0 0 0 0 0 0 0 1 0 0 0 1 1 0 0 6 1 0 0 0 0 0 0 0 0 0 0 0 1 1 1 1 
1 1 1 1 0 1 1 1 1 1 1 0 0 0 0 1 0 0 0 1 1 0 6 0 1 0 0 0 0 1 1 1 1 1 1 1 1 1 1 1 
1 1 1 1 0 1 0 6 0 0 1 0 1 1 1 1 6 0 0 1 1 0 0 0 1 1 1 1 0 1 0 0 0 0 0 1 1 1 1 1 
1 1 1 1 0 1 0 0 0 0 1 0 1 0 0 0 0 0 0 1 1 0 0 0 0 0 0 1 0 1 0 6 0 0 0 1 1 1 1 1 
1 1 1 1 0 1 0 1 0 6 1 0 1 0 0 5 0 0 0 1 1 0 0 0 5 0 0 1 0 1 0 0 1 0 6 1 1 1 1 1 
1 1 1 1 0 1 1 1 0 0 1 0 1 0 0 0 6 0 0 1 1 0 0 6 0 0 0 1 0 1 0 0 1 1 1 1 1 1 1 1 
1 1 1 1 0 0 0 1 0 0 1 0 1 0 0 0 0 0 1 1 1 1 0 0 0 6 0 1 0 1 0 6 1 0 0 0 1 1 1 1 
1 1 1 1 0 0 0 1 0 0 1 0 1 0 6 0 6 0 1 0 0 1 0 0 0 0 0 1 0 1 0 0 1 0 0 0 1 1 1 1 
1 1 1 1 0 0 0 1 0 0 1 0 1 0 0 5 5 5 1 0 0 1 5 5 5 0 0 1 0 1 0 0 1 0 0 0 1 1 1 1 
1 1 1 1 0 0 0 1 0 0 1 0 1 0 6 5 5 5 1 0 0 1 5 5 5 0 6 1 0 1 0 0 1 0 0 0 1 1 1 1 
1 1 1 1 0 0 0 1 0 6 1 0 1 0 0 5 5 5 1 0 0 1 5 5 5 0 0 1 0 1 6 0 1 0 0 0 1 1 1 1 
1 1 1 1 0 0 0 1 0 0 1 0 1 0 0 0 0 0 1 0 0 1 0 0 0 0 0 1 0 1 0 0 1 0 0 0 1 1 1 1 
1 1 1 1 0 0 0 1 0 0 1 0 1 0 0 0 0 0 1 0 0 1 0 0 6 0 0 1 0 1 0 0 1 0 0 0 1 1 1 1 
1 1 1 1 0 0 0 1 0 0 1 1 1 0 0 0 0 0 1 1 1 1 0 6 0 0 0 1 1 1 0 6 1 0 0 0 1 1 1 1 
1 1 1 1 0 0 0 1 0 0 5 5 5 0 0 0 0 6 0 1 1 0 0 0 0 0 0 5 5 5 0 0 1 0 0 0 1 1 1 1 
1 1 1 1 0 0 0 1 0 6 0 6 0 0 6 0 0 0 0 1 1 0 0 0 0 0 0 6 0 0 0 0 1 0 0 0 1 1 1 1 
1 1 1 1 0 0 0 1 0 0 0 0 0 0 5 5 0 6 0 1 1 5 5 0 0 0 0 0 0 0 0 0 1 0 0 0 1 1 1 1 
1 1 1 1 0 0 0 1 0 0 0 0 1 1 1 1 1 1 1 1 1 1 1 1 1 1 1 1 1 1 0 6 1 0 0 0 1 1 1 1 
1 1 1 1 0 0 0 1 0 0 1 0 0 6 0 0 6 0 0 1 0 0 0 0 0 0 0 0 0 1 0 0 1 0 0 0 1 1 1 1 
1 1 1 1 0 0 0 1 6 0 1 0 0 0 0 0 0 0 0 1 0 0 0 6 0 0 0 6 0 1 0 0 1 0 0 0 1 1 1 1 
1 1 1 1 0 0 0 1 0 0 1 0 0 0 0 0 0 0 0 1 0 0 0 0 0 0 0 0 0 1 0 0 1 0 0 0 1 1 1 1 
1 1 1 1 0 0 0 1 0 0 1 1 1 1 1 1 1 0 6 1 0 5 1 1 1 1 1 1 1 1 0 6 1 0 0 0 1 1 1 1 
1 1 1 1 0 0 0 1 0 0 0 0 0 0 0 0 0 0 0 1 0 0 0 0 6 0 0 0 0 6 0 0 1 0 0 0 1 1 1 1 
1 1 1 1 0 0 0 1 0 0 0 0 6 0 0 0 0 0 0 1 0 6 0 0 0 0 0 0 0 0 0 0 1 0 0 0 1 1 1 1 
1 1 1 1 0 0 0 1 6 0 0 5 5 0 0 0 6 0 0 1 0 0 0 0 0 5 5 0 0 0 0 0 1 0 0 0 1 1 1 1 
1 1 1 1 0 0 0 1 1 1 1 1 1 1 1 1 1 1 1 1 1 1 1 1 1 1 1 1 1 1 1 1 1 0 0 0 1 1 1 1 
1 1 1 1 1 1 1 1 1 1 1 1 1 1 1 1 1 1 1 1 1 1 1 1 1 1 1 1 1 1 1 1 1 1 1 1 1 1 1 1 
1 1 1 1 1 1 1 1 1 1 1 1 1 1 1 1 1 1 1 1 1 1 1 1 1 1 1 1 1 1 1 1 1 1 1 1 1 1 1 1 
1 1 1 1 1 1 1 1 1 1 1 1 1 1 1 1 1 1 1 1 1 1 1 1 1 1 1 1 1 1 1 1 1 1 1 1 1 1 1 1 
1 1 1 1 1 1 1 1 1 1 1 1 1 1 1 1 1 1 1 1 1 1 1 1 1 1 1 1 1 1 1 1 1 1 1 1 1 1 1 1 